12 12 12 12 12 12 12 12 12 12 12 12 12 12 12
12 0  0  0  0  0  0  0  0  0  0  0  0  0  12
12 0  0  0  0  0  0  0  0  0  0  0  0  0  12
12 0  0  1  2  3  4  5  6  7  8  9  10 0  12
12 0  0  0  0  0  0  0  0  0  0  0  0  0  12
12 0  0  0  0  0  0  0  0  0  0  0  0  0  12
12 0  0  0  0  0  0  0  0  0  0  0  0  0  12
12 0  0  0  0  0  0  0  0  0  0  0  0  0  12
12 0  0  0  0  0  0  0  0  0  0  0  0  0  12
12 0  0  0  0  0  0  0  0  0  0  0  0  0  12
12 0  0  0  0  0  0  0  0  0  0  0  0  0  12
12 0  0  0  0  0  0  0  0  0  0  0  0  0  12
12 0  0  0  0  0  0  X  0  0  0  0  0  0  12
12 0  0  0  0  0  0  0  0  0  0  0  0  0  12
12 0  0  0  0  0  0  0  0  0  0  0  0  0  12
12 12 12 12 12 12 12 12 12 12 12 12 12 12 12